One continuous line|âœï¸
Use only circles|â­•
Use only squares|â¬œ
Non-dominant hand|ğŸ¤š
Draw upside down|ğŸ™ƒ
Eyes closed|ğŸ˜‘
Use only dots|â€¢
Draw in 30 seconds|â±ï¸
Tiny (thumb-sized)|ğŸ¤
HUGE (fill the page)|ğŸ“„
Use only 3 colors|ğŸ¨
Make it rainbow|ğŸŒˆ
Only straight lines|ğŸ“
Only curved lines|ã€°ï¸
Add patterns everywhere|ğŸ”²
Make it symmetrical|ğŸª
Robot version|ğŸ¤–
Draw it melting|ğŸ’§
Draw it flying|ğŸ•Šï¸
Add silly accessories|ğŸ©
Draw it dancing|ğŸ’ƒ
Make it look angry|ğŸ˜ 
Make it look happy|ğŸ˜„
Draw it wearing a hat|ğŸ§¢
Give it superpowers|âš¡
Baby version|ğŸ‘¶
Make it sparkly|âœ¨
Draw it in a storm|ğŸŒ©ï¸
Draw it sleeping|ğŸ˜´
Shapes only|ğŸ”·