Wild Animals|ğŸ¦
Pets|ğŸ•
Ocean Creatures|ğŸ 
Birds|ğŸ¦…
Insects|ğŸ¦‹
Dinosaurs|ğŸ¦•
Dragons|ğŸ‰
Monsters|ğŸ‘¾
Robots|ğŸ¤–
Aliens|ğŸ‘½
Superheroes|ğŸ¦¸
Princesses & Knights|ğŸ‘‘
Pirates|ğŸ´â€â˜ ï¸
Ninjas|ğŸ¥·
Wizards|ğŸ§™
Fairies|ğŸ§š
Mermaids|ğŸ§œ
Space & Planets|ğŸª
Weather|â›ˆï¸
Seasons|ğŸ‚
Food & Snacks|ğŸ•
Desserts|ğŸ°
Vehicles|ğŸš—
Buildings|ğŸ¢
Trees & Plants|ğŸŒ³
Flowers|ğŸŒ»
Sports|âš½
Musical Instruments|ğŸ¸
Toys|ğŸ§¸
School Supplies|âœï¸
Emotions/Feelings|ğŸ˜Š
Underwater World|ğŸ™
Circus|ğŸª
Farm Life|ğŸšœ
Jungle Adventure|ğŸŒ´
Arctic Animals|ğŸ§
Desert Life|ğŸŒµ
Mythical Creatures|ğŸ¦„
Household Items|ğŸ 
Playground Equipment|ğŸ 